##################
#.........#.#.....
#########.#...##.#
#...#.#...#####..#
#.#...###.#.....##
#.#.#.....#.######
#.####.#.##...#..#
............####.#
##################