##################################################
#.##.#.......###..#...#...#..........#.....###...#
#....#.#.###..#..#..#...##..#.##.##.#..###..#..#.#
#.#.#...#...#...##.#.##..#.#.#..#...#.#...#...#..#
#.#..#.#..#..#.#.....#.#.#.#...##.#.#..#.#..##..##
##..#..#.#.#.#..#.##...#.#..#.#...#.#.#...#..#####
#..##.##...#..#...#..##...#.#.#.##..#..##..#....##
#.#...#..##.#.#.#..##...#.#.#.#.##.###....#####..#
#.#.#.#.##..#..#..#...#..##.#.#...#.#.###..#...#.#
#.#.#.#.#..#..#..#..##.##...#..##.#...#...#..#.#.#
#....##.#.#..#####.#......##.#..#..##.#.###.##.#.#
#.#.#...#...#.#....#.#.####...#..#....#.#...#..#.#
#.##..##..##....###...#.....#...###.#.#..#.#..#..#
#..#.#.#.#...####...##..##.#..#..#..#.#.#..##.#.##
#.#..#.#..##......###..#.#.#.#.#.#.#..#.#.#...#..#
#.#.##..#...#.#.##....#...#..#..#..###..##..##..##
#.#.#..#.##..#.....###..#...##.#..#...#..#.###.#.#
##..#.##...#.#.####...#..###...#.#..#..#.#..#....#
##.#.....#.#..#....##..#.#..#.#....##.##..#.#.##.#
#..#.#.##.#..#..##...#....#...#.####....#.#.#..#.#
#.#.##....#.###.#..#..###...#..#.....####....#..##
#.....##.##.##...##.#...####..#..###.#...##.#.#..#
#.###.##......##.....##....##.#.#...##.#..#.#..#.#
#...#...#.###..#####...###...#....#....##.....#..#
###..##..#...#.....###.#..##.#.####.#.#..#.####.##
#.#.#..#...#..####...#.#.##..###...#..##..#......#
#...#.#.#####.#...##...#.#..#....#.##....##.####.#
#.##.......#..#.#.#.###..#.#..####...##.#...#...##
#.#.#.#.####.##.#.......#...#.#....#...#..##..#..#
#.....##.....#...######..#.#..#.#.#.#.#..#.#.###.#
##.###...####.#.#......#...#.##.##..#.##.#.#..##.#
#.#....##.....#..#.##.######...#...#...#...#.#...#
#.#.###...##.###.#.#...#....##.#.#.#.#..##...#.#.#
#.#.#..#.##...#..#..#.#..##.#..#.#..#.#...#.##..##
#.#..#..##..#.#.#.#.#...##..#.#...#.#..##.#...#..#
#..#..#....#.#..#..#..#.#..#....###..#..#..###..##
#.#.#.###.#..#.#.#...#.#..#.#.##...#..#..#...#.#.#
#...#...#...##....#.#....#...#...#..#.##..##...#.#
#.#..##..##...#.#...#.#.#.##...##..#....#...##.#.#
#..#...#..#.#....#.#.#..#..##.#.##.#.#.#..#..#...#
#.#####.#.#..####..#.#.#.#....#.....#..#.#.#..##.#
#..#....#..##....##..#....#.#.#####..#.#.#.##....#
##...##.#.#...##....#.###.#.##.....#.#.##....#.#.#
#..##...#...##..####....#.#....#.#.#.#....##..##.#
###...##.###...#.....##.#.#####..#.#..#.#...#.#..#
#...#.#......##..##.#...#......##...#.##..###..###
#.####..#.##..#.#..#..#..###.#.##.##....##...#...#
#...##.#..#.###.##.#.#.##...##....#..##.##.#.###.#
#.#.....#..........#......#....#.#..#......#.....#
#################.################################
