#.################
#.........#.#....#
#########.#...##.#
#...#.#...#####..#
#.#...###.#.....##
#.#.#.....#.######
#.####.#.##...#..#
#...........####.#
##################